NO         ./resources/textures/bluestone.xpm
SO     ./resources/textures/colorstone.xpm
WE ./resources/textures/greystone.xpm
EA ./resources/textures/purplestone.xpm

F    220,100,0


C                                       225,30,0

111111
111101
1111N1
111111