NO ./resources/textures/bluestone.xpm
SO ./resources/textures/colorstone.xpm
WE ./resources/textures/greystone.xpm
EA ./resources/textures/purplestone.xpm
F 200,120,120
C 120,120,120

111111111
100101111
101001
1100N1
111111

   111111
111101111
101001
110001
111111