NO ./resources/textures/bluestone.xpm
F 220,100,0

SO ./resources/textures/colorstone.xpm

WE ./resources/textures/greystone.xpm
C 226,30,255

EA ./resources/textures/purplestone.xpm


        1111111111111111111111111
     1 11000000000110000000000001
    10100011000001110000000000001
    10001001000000000000000000001
111111111011000001110000000000001
100000000011000001110111111111111
11110111111111011100000010001
11110111111111011101010010001
11000000110101011100000010001
10000000000000001100000010001
10000000000000001101010010001
11000001111101011111011010N0111
11110111 1110101 101111000001
11111111 1011111 111111111111
