NO ./resources/textures/bluestone.xpm
SO ./resources/textures/colorstone.xpm
WE ./resources/textures/greystone.xpm
EA ./resources/textures/purplestone.xpm
F 220,100,0
C 225,30,0

        1111111111111111111111111
        10000000001100000000000011
        10110000011100000000000011
        11010010000000000000000001
1111111110110000011100000000000011
100000000011000001110111101111111
11110111111111011100000010001
11110111111111011101010010001
11000000110101011100000010001
1000000000000000110000001000111
1000000000000000110101001000001
11000001110101011111011110N0111
11111111 1111111 11111111111111