NO ./resources/textures/bluestone.xpm
SO ./resources/textures/colorstone.xpm
WE ./resources/textures/greystone.xpm
EA ./resources/textures/purplestone.xpm
F 220,10,0
C 225,30,0

111111111111
100010101001
1000000N1001
100000000101
100000111001
111111111111